Ahlamula"	Yawn
Ahlula"	Judge
Aka"	Build
Akani"	Build. Build together
Ala"	Refuse. Deny
Ambala"	Wear
Ambaleka"	Wearable 
Ambarile"	Wore
Ambexa"	Dress
Amukela"	Receive. Welcome. Appreciate. Accept
Amukelani"	Receive. Welcome. Appreciate. Accept
Amukelo"	Acceptance
Anakanya"	Think
Anama"	Broad. Wide
Anamile"	Broad. Wide
Anarhoko"	Petticoat
Andlala"	Lay. Lay a blanket on the ground or bed.
Andza"	Multiply
Andzani"	Multiply
Angarha"	Cover
Angula"	Answer. Respond
Angulo"	Response. An answer
Antswa"	Better
Antswisa"	Better. Make something better
Arile"	Denied
Ava"	Divide
Avanyisa"	Judge. Divide
Avile"	Divided
Avuxeni"	East. A greeting in the morning
Badama"	Lie down
Badi"	Bad luck
Baji"	Jacket
Baku"	Cave
Baleka"	Explode
Baleka"	Explode
Baleka"	Run
Balekile"	Exploded
Bamba"	Hump
Bamba"	Bounce
Bambetela"	Pat
Bana"	Beat
Banana"	Fight. People fighting
Bandala"	-
Bandhi"	Belt, Band.
Banga"	Sword
Bangala"	 African Cabbage
Barha"	Wheelbarrow
Barika"	Boat
Barisa"	Register
Basa"	Clean
Basa"	White
Basani"	Be Clean. Be White.
Basile"	Clean
Basisa"	Cleanse
Basuluka"	Pale
Bava"	Chilly. Sour
Bawuri"	Catfish
Bazela"	Bonus. Something extra
Belela"	Nail
Bendlele"	Bracelet
Biha"	Ugly. Bad
Bihisa"	Spoil. Impair
Bikiri"	Mug
Bindzu"	Business
Bindzula"	Profit
Bindzulo"	Profit. Gain
Biya"	Fence in
Biyela"	Fence in
Boboma"	Waterfall
Bodlha"	Belch
Bodo"	Hole. Pore
Bofu"	Blind person
Boha"	Mandatory. Compulsory
Boha"	Tie. Bind
Bohiwa"	Tied. Indicted. Be tied
Bokoloka"	Speak too much
Bola"	Rot
Boleni"	Rotting
Bomba"	Show off. To wear newer nice clothes
Bombisa"	Decorate
Bomu"	Lime
Borha"	Bore
Borha"	Drill
Borheka"	Bored
Borho"	Drill
Borile"	Rotten
Borisa"	Spoil
Borota"	Plate
Botere"	Butter
Boxa"	State
Boxa"	Pierce
Buba"	Struggle
Bubutsa"	Storm
Bukuta"	Beat
Bukuxa"	Swim
Bula"	Talk. Converse
Bulo"	Conversation
Bulomu"	Flower
Buluka"	Explode. Burst. Blast
Buma"	Boast
Burile"	Conversed. Talked
Buruku"	Trouser
Buwa"	Clod
Bvanyingeta"	Crush. Deform
Bvubvuka"	Swell
Bvubvukile"	Swollen
Bvutama"	Crouch quickly
Bvutamela"	Ambush
Byabya"	Bubble
Byabyeni"	Roof. A house with a grass roof
Byaka"	Break surface
Byako"	Dwelling
Byala"	Plant
Byalwa"	Beer
Byamela"	Incubate eggs
Byanyi"	Grass
Byatso"	Boat
Byatsweni"	Abroad
Byeke"	Abdomen
Byela"	Tell
Byetlelo"	Sleeping place
Byevula"	Skin shedding
Byewu"	Bark-fibre
Byi"	This
Byobyebyi"	These ones
Byona"	That.  For nouns starting with 'by'
Byongo"	Brain
Cabyatela"	Wade
Caca"	Chase. Scold
Cakunya"	Chew
Cambuta"	Flick lightly
Cawuka"	Anxious
Ceka"	Fabric
Cela"	Dig
Celeni"	Digging
Cema"	Groan. Cry. Scream
Cerile"	Dug
Chachamela"	Sizzle
Chacharha"	Bubble
Chapu"	Cut. Finish
Chaputa"	Finish up
Chava"	Fear
Chavela"	Take refuge
Chavelela"	Comfort
Chavisa"	Intimidate. Frighten.
Chaya"	Play a musical instrument
Chayela"	Drive
Chayisana"	Collide
Checha"	Slander
Chefu"	Poison
Chela"	Pour
Chela"	Frog
Chelela"	Poison
Chelele"	Bird Crop
Cheleni"	10 cents
Cheleta"	Irrigate
Cheyeza"	Bright
Chicha"	Unload
Chika"	Descend
Chikisa"	Unload
Chivirika"	Zealous
Chocha"	Walk audibly
Chochovela"	Walk. Walk through bushes
Chona"	Borrow money
Chucha"	Untie
Chukela"	Sugar
Chuluka"	Diarrhea
Chulula"	Pour out
Chululela"	Pour. Pour for. Pour into
Chupuka"	Slip away
Cikinya"	Swing
Cina"	Dance
Cinama"	Bare
Cinamisa"	Show bare teeth
Cinca"	Change
Cinceni"	Changing
Cineni"	Dancing
Cingela"	Glance. Stare.
Cinile"	Danced
Civa"	Withhold
Copa"	Shoot
Copeta"	Blink
Cukumeta"	Throw
Dakwa"	Drunk
Damarha"	Adhere
Damarhela"	Stick
Damurhuta"	Draw apart
Danisa"	Embarrass
Darata"	Fencing wire
Dari"	Fever
Debya"	Loose
Debyile"	Loose
Debyisa"	Slacken
Dedeleka"	Stagger
Delela"	Disrespect
Dewula"	Swing
Dewulana"	Bat
Deya"	Walk. Try to walk. Learn to walk
Dikida"	Tickle
Dikizela"	Lid
Dladla"	Camp
Dlawa"	Killed. Get killed
Dlaya"	Kill
Dlayetela"	Exterminate
Dliva"	Poke
Dlokodla"	Poke
Dlonyola"	Poke
Dludla"	Stir
Dodomedzi"	Stupid. A stupid person
Dokodela"	Doctor
Dokomela"	Asclepia Fruitcomum
Domu"	Stupid. A stupid person
Donga"	Ditch
Doroba"	Town
Dorobankulu"	City
Dorwana"	Pear
Duku"	Head cloth
Dulu"	Granary
Duma"	Sound. Make sound
Dunga"	Stir
Durha"	Expensive
Durhisa"	Raise price
Dya"	Eat
Dyambu"	Sun
Dyana"	Eat
Dyandza"	Famine. Drought
Dyela"	Deprave
Dyelo"	Pasture
Dyisa"	Feed
Dyiwile"	Eaten. Get eaten
Dyoha"	Sin
Dyohela"	Sin againist
Dyohisa"	Corrupt
Dyona"	Him. Her. For nouns starting with 'dy'
Dyondza"	Learn
Dyondzeka"	Get educated
Dyondzekile"	Educated. Learned
Dyondzisa"	Teach
Dyuhala"	Grow old
Dyuhata"	Cause to grow
Dzaha"	Smoke
Dzamu"	Breast
Dzana"	Hundred
Dzedze"	Flea
Dzevula"	Molt
Dzima"	Set up. Stick into
Dzimba"	Cheetah
Dzindza"	Thunder
Dzinginika"	Quake
Dziribya"	Suddenly stand
Dziva"	Thick
Dzivamisoko"	April
Dzolonga"	Dispute
Dzonga"	South
Dzovo"	Skin
Dzudza"	Shake off
Dzudzumeta"	Push
Dzuka"	Perspire
Dzuna"	Praise
Dzuneka"	Holy. Praisable
Dzungudza"	Shake. Shake you head
Dzunisa"	Praise
Dzunisani"	Praise. Praise together.
Dzuvuka"	Grow blad
Dzuvula"	Cast skin
Dzwavi"	Witch doctor
E!"	Interjection of suprise
E-e"	No
Ehla"	Descend
Ehleketa"	Think
Ehlisa"	Lower
Eka"	Dear. To.
Enca"	Imitate
Encanyeta"	Imitate
Encisa"	Imitate
Endla"	Make. Create. Do
Endleka"	Practical
Endza"	Visit
Endzela"	Visit
Endzeni"	Inside
Endzhaku"	Behind
Enela"	Enough
Enerisa"	Satisfy
Eneta"	Suffice
Engeta"	Repeat
Engetela"	Increase
Enta"	Deep
Entshemula"	Sneeze
Etlela"	Sleep
Etlerile"	Slept
Fakaza"	Testify
Fakazi"	Witness
Famba"	Go
Fambafamba"	Take a walk
Fambani"	Go
Fambile"	Went
Fana"	Like
Fanana"	Alike
Fananisa"	Compare. Make alike
Fanekela"	Suit
Fanela"	Suit
Fanelo"	Duty
Fanisa"	Compare
Fasikoti"	Apron
Faya"	Break
Fayeka"	Breakable. Break easily
Fayetela"	Smash
Fayile"	Broke
Fehla"	Stinging pain
Felangati"	Bruise
Fendlele"	Scent
Fenyeta"	Joke
Fetha"	Stir mealie
Fidzula"	Bruise
Fihla"	Hide
Fihlula"	Eat breakfast
Fihluta"	Offer breakfast
Fika"	Arrive
Fikela"	Reach
Fikile"	Arrived
File"	Died
Fimila"	Mucus
Fohla"	Break out
Fokisa"	Spy
Fokisi"	Detective
Fola"	Queue
Fole"	Tobacco
Foroma"	Mould bricks
Foromo"	Brick mould
Fukelo"	Texture
Fukula"	Dig up
Fularha"	Abandon
Fularhela"	Forsake
Fuma"	Rein
Fumbarhela"	Hold. Hold with closed hands
Fumisa"	Enrich
Fundza"	Keep something in the mouth
Fundzu"	Knot
Funengela"	Put on
Fungha"	Mark
Funungula"	Uncover. Open a pot
Funya"	Eat fast
Furha"	Oil
Furniture"	Nhundu ya le ndlwini
Furwa"	France
Futa"	Careless
Fuwa"	Posses
Gaa"	Lie on your back
Gada"	Climb on
Gadi"	Clod
Gaja"	Catch. Catch quickly
Galagala"	Climb a tree quickly
Gama"	Eagle
Gamba"	Turtle
Gamboko"	Snow
Ganakulu"	Turkey
Ganama"	Lie on your back
Gandla"	Stamp
Gandlati"	Wave
Gandzela"	Worship
Gandzelo"	Sacrifice
Ganga"	Hill
Gangamuka"	Stop raining for a while
Gangisa"	Propose. Propose a relationship
Ganju"	Crab
Garingani"	Story-teller
Gava"	Catch
Gavaza"	One who dresses elegantly
Gaxa"	Bundle
Gayela"	Ruminate. Grind
Gega"	Insinuate
Gelegele"	Slut
Geleza"	Sleeping around
Gerere"	-
Getsela"	Gnash
Geva"	Belch
Gewu"	Monkey
Gezani"	Xitsonga traditional name
Gezi"	Electricity
Gidi"	Thousand
Gimeta"	Lean against
Gingirika"	Be busy
Giya"	Dance
Goba"	Sow mealies
Goji"	Hole
Golonyi"	Wagon
Gombonyoka"	Twisted
Gome"	Sorrow
Gomela"	Moan
Gomo"	Forehead
Gondzo"	Path
Gongomela"	Mercury. Evening star
Gongondza"	Knock
Gonya"	Climb
Govela"	Traditional healers teacher
Goza"	Step. Walking step. 
Gugu"	Shortlived enthusiasm
Gumba"	White stork
Gume"	Rag
Gungula"	Complain
Gwembe"	Cattle disease
Gweva"	Convict. Sentence
Gwitsila"	Freeze
Haha"	Fly
Hahani"	Aunt
Hahluka"	Blown off
Hahlula"	Blow off
Hahu"	Lung
Haka"	Hook onto
Hakamela"	Remain suspended
Hakarha"	Carry over ones sholder
Hakasa"	Stir
Hakela"	Pay
Hakelo"	Payment
Hakunene"	Indeed
Hakuta"	Extract
Halenu"	This side
Hambana"	Different. Unique
Hambana"	Depart. Seperate
Hambanyisa"	Separate
Hambanyisile"	Separated
Hambanyisiwa"	Separated
Hambi"	Although
Hambiloko"	Even though
Hambuka"	Stray. Go out of the way
Hambukile"	Strayed. Out of the way.
Hambukisa"	Lead astray
Hanana"	Generous
Handle"	Outside
Handza"	Scratch the ground
Handzelo"	Yeast
Handzuka"	Torn
Handzula"	Tear
Handzulo"	Operation
Hangalasa"	Scatter
Hansi"	Under. Down
Hanya"	Live
Hanyanya"	Awake. Stay awake
Hanyelo"	Behaviour
Haraka"	Rake
Hari"	Crown
Hatima"	Shine. Be bright.
Hatla"	Haste
Hatlisa"	Hurry
Havelo"	Armour
Haxa"	Broadcast
Haxawa"	Next year
Hefemula"	Breath
Hehla"	Accuse
Heke"	Gate
Hele"	Cockroach
Heleketa"	Accompany
Hemba"	Lie
Hembe"	Shirt
Henhla"	Top. Up. Above 
Herisa"	Abolish
Heta"	Finish
Hetelela"	Last
Hetile"	Finished
Hetisa"	Finish
Hetisisa"	Fulfil
Hi"	By
Hikiwa"	Limited
Hiko"	Full stop
Hikokwalaho"	Because
Hikombirhi"	Colon
Hikuva"	Because
Hikwalaho"	Because
Hikwana"	Semicolon
Hima"	Beat
Himbi"	African mangosteen
Hina"	Us
Hinkwako"	Everywhere
Hinkwaswo"	All
Hinkwaswo-nkwaswo"	All together
Hinkwavo"	Everyone. Everybody
Hinkwenu"	All of us
Hinkwenu"	You all
Hirha"	Hire
Hisa"	Burn. Hot
Hiseka"	Zealous
Hiseko"	Passion
Hiteka"	Vigilant
Hlakahla"	Shake to pieces
Hlakala"	-
Hlakula"	Remove weeds
Hlamalani"	Surprised
Hlamarisa"	Astonish
Hlamba"	Bath
Hlambanya"	Swear
Hlambela"	Swim
Hlangana"	Meet
Hlanganisa"	Connect
Hlangula"	Wipe
Hlanta"	Vomit
Hlantswa"	Wash
Hlanya"	Crazy
Hlapfa"	Emigrant
Hlata"	Vomit
Hlati"	Forest
Hlawula"	Choose
Hlawuleka"	Unique. Choosable
Hlaya"	Read
Hlayisa"	Preserve
Hleka"	Laugh
Hleketa"	Think
Hlenga"	Collect
Hleva"	Gossip
Hlola"	Do something taboo
Hlolwa"	African Wild Dog
Hloma"	Go stay at husband or boyfriend's house
Hlomisa"	Take one's bride home
Hlonga"	Slave
Hlongorisa"	Chase
Hlori"	Wonder
Hlota"	Hunt
Hlulani"	Win. Conquer
Hlupa"	Bother
Hlupha"	Trouble. Difficult. To trouble someone. 
Hlupheka"	Suffer
Hluva"	Remove features
Hluvuka"	Progress. Develop. Improve
Hluvula"	Undress
Hlwanya "	Sow. Sow seed
Hlwela "	Delay
Hodela"	Hotel
Holobye"	Minister
Holobyenkulu"	Prime Minister
Holova"	Fight
Homu"	Cow
Honci"	Pig
Hongonyi"	Wildebeest
Honisa"	Ignore
Horisa"	Cue
Hosana"	Chief
Hosela"	Project
Hosi"	King
Hosikati"	Queen
Hosinkulu"	Paramount king
Hoxa"	Fault
Hoxa"	Throw
Hoxani"	Throw
Hoxekile"	Wrong
Hoxile"	Threw. Faulted
Hoyozela"	Celebrate. Welcome
Hubyana"	Chief's/Prince's court
Huku"	Chicken
Hukuri"	November
Huma"	Go out
Humba"	Snail
Humesa"	Extract. Take out.
Hundla"	Trim
Hundza"	Pass
Hundzeke"	Previous
Hundzisa"	Surpass
Hundzukile"	Changed
Hunga"	Blow air
Hungasa"	Intertain
Hungela"	Blow air
Hungela"	Annoy. Irritate. Bother.
Hunguta"	Reduce. Lessen
Hunguta"	Reduce
Hungutile"	Reduced
Hunguva"	Fog
Hunyi"	Firewood
Huvo"	Court
Huvo"	King's court
Ina"	Yes
Ingi"	If
Inkomu"	Thanks
Jaha"	Young male
Jaha"	Gallop
Jamuka"	Speak nonsense
Jarati"	Yard
Jarimani"	Germany
Jasi"	Overcoat
Javulosi"	Devil
Jeke"	Jug
Jelwana"	Porcupine
Jenjhe"	Termite
Jesi"	Jersey
Jikajika"	Zigzag
Jitama"	Jump down
Johana"	John
Joko"	Yoke
Jongela"	Prospect
Joni"	Johannesburg
Juva"	Strip off features
Ka"	At
Kafu"	Plane
Kahle"	Well. Fine
Kahlula"	Walk quickly
Kakatlula"	Pull apart
Kala"	Scarce
Kalaka"	Lime
Kalavatla"	Watermelon
Kalavatla"	Watermelon
Kama"	Squeeze
Kamara"	Room
Kamba"	Check
Kamba"	Shell
Kambe"	But
Kambela"	Examine
Kambirhi"	Twice
Kan'we"	Once
Kan'wekan'we"	At once
Kanakana"	Hesitate
Kandza"	Crush
Kandziya"	Tread upon
Kanela"	Discuss
Kaneta"	Deny
Kangani"	How many times
Kanganyisa"	Cheat
Kanyi"	Marula tree
Karhata"	Trouble. Tease
Karhele"	Tired
Kariha"	Be angry
Kasa"	Crawl
Kasi"	Whereas.
Katekani"	Be blessed
Katekisa"	Bless
Katekisile"	Blessed
Katinga"	Roast in a pot
Katla"	Shoulder
Katsa"	Unite
Katsakanya"	Summarize
Kaya"	Home
Kayakaya"	Struggle
Kayakaya "	Doubt
Kaye"	Nine
Kereke"	Church building
Ketani"	Chain
Ketlele"	Kettle
Khabodo"	Cupboard
Khale"	Long ago
Khaluta "	Pass
Khamba"	Thief
Khanimambo"	Good bye and thank you
Khapa"	Run over
Khata"	Capture
Khayithi"	Kite
Khegu"	Old lady
Khehela"	Armpit
Khekhe"	Cake
Khensa"	Thank
Khensani "	Grateful
Khensisa"	Thankful
Khida"	Swim
Khiya"	Lock
Khiyile"	Locked
Khohlola"	Cough
Kholwa"	Believe
Khoma"	Catch
Khomana"	Cleave
Khombo"	Accident
Khombomuni"	Adversity. A kind of adversity !?
Khomela"	Forgive
Khomiwile"	Arrested 
Khongela"	Pray
Khongelela"	Intercede. Pray for someone
Khongoloti"	Myriapod
Khoro"	Gate
Khorwisa"	Convince
Khotavuxika"	June
Khotsa"	Arrest
Khotso"	Prison
Khudzehela"	Grow sleepy
Khudzu"	Thumb
Khula "	Sip warm beverage
Khula"	Drink
Khumba"	Bushpig
Khumbi"	Wall
Khume"	Ten
Khwati "	Forest
Khwiri"	Stomach
Khwita"	Limp
Kijawa"	Guava
Koka"	Pull
Kokova"	Creep
Kokwana"	Grandparent
Kolombyani"	Striped Skink
Koma"	Short
Komba"	Show. Display
Kombe"	Spoon. Cooking spoon
Kombela"	Ask
Kombeta"	Show
Komisa"	Abbreviate. Summarise. Shorten.
Kompfa"	Banana
Kona"	Present. Available
Kondlo"	Rat
Kondzo"	Foot
Korhoka"	Serve
Korisela"	To finish the last of something
Kota"	Able
Koti"	Vulture
Koxa"	Allege
Ku"	To
Ku-Fa"	To Die
Kufumela"	Lukewarm
Kufumeta"	Warm up
Kuhlula"	Win. To win
Kukula"	Sweep
Kukumuka"	Swell up
Kukumuxa"	Boast
Kula"	Grow
Kulani"	Grow
Kule"	Far
Kulelo"	Progress
Kulobye"	Mate
Kulu"	Big
Kuma"	Find
Kumba"	Blanket
Kumbe"	Perhaps
Kumbexana"	Maybe
Kumeka"	Available
Kun'wana"	Elsewhere
Kunene"	Verily
Kungu"	Plan
Kunguhata"	Make plan
Kungwa"	Mist
Kunjhani"	How are you
Kurhula"	Peace
Kurisa"	Increase
Kusuhi"	Near
Kusukela"	From
Kutani"	Then
Kute"	Then
Kuteloko"	Thereafter
Kuteloko"	Thereafter
Kutsula"	Redeem
Kuva"	Being
Kuwa"	Fig
Kuxu"	Moss
Kwala"	Here
Kwale"	There
Kwaleyo"	There
Kwata"	Sad
Kwetsima"	Holy
Kwetsimisa"	Hallow
Kwihi"	Where
Kwihi-na-kwihi"	Anywhere
La"	Here
Laha"	Here
Lahayani"	There
Lahla"	Lose
Lahleka"	Astray
Lahlekile"	Lost
Lahlisa"	Misguide
Lakani"	Sheet
Lamula"	Orange
Lamula"	Seperate people from fighting
Landelaka"	Next
Landza"	Follow. Walk behind
Landzela"	Follow after
Langavi"	Flame
Langha"	Choose
Langhile"	Chose
Languta"	Look
Langutile"	Looked
Lanwa"	Grumble. Grumble and abandon as a result 
Larisa"	Make narrow
Lata"	Put to bed
Lava"	Want
Lavaya"	Them
Laveka"	Require
Lawu"	Boys' house
Lebvu"	Beard
Lebyinene"	Good one
Lebyiya"	That one
Leha"	Long
Lehisa"	Lengthen
Lembe"	Year
Lemuka"	Realize
Lepula"	Spoon
Leri"	This one
Lerinene"	Great one
Leswaku"	In order to
Leswi"	These
Leswinene"	Something good
Letela"	Advice. Exhort. Join
Lexi"	This
Lexiya"	That
Loko"	If
Lolo"	Lazzy fellow
Loloha"	Lazy
Lolohisa"	Discourage
Lomba"	Borrow
Londza"	Demand
Lorha"	Dream
Losa"	Honour. Respect
Lova"	Die. Perish
Loya"	Bewitch
Loyi"	This one
Lulama"	Upright
Lumula"	When an infant stops being breastfed
Lungha"	Upright
Luswi"	Swarm
Luvani"	-
Lwandle"	Sea
Lwandlenkulu"	Ocean
Lwangu"	Roof
Machokolobyani"	Bush
Madleke"	Light-beer
Madyambu"	Evenining
Madyondziselo"	Doctrine
Madzana"	Hundreds
Mafanato"	Dying with something
Mafasitere"	Windows
Mafenya"	Laughter
Mafu"	Deaths
Mafundzu"	Knots
Mafurha"	Oil
Magandzelo"	Ritual
Magaraba"	A person coming back from the city
Magayisa"	A person coming back from the city
Magezi"	Xitsonga traditional name
Magwarhi"	Cracked heels
Magwinya"	Fatcakes
Mahahlwa"	Twins
Mahahu"	Lungs
Mahala"	In vein
Mahanyelo"	Lifestyle
Mahewu"	Beer
Mahiri"	Proverb
Mahlo"	Eyes
Mahlweni"	Forward
Mahosi"	Behind
Mahungu"	News
Mahungu-ndlela"	Rumours
Majana"	Bee Larvae. Baby bee
Makala"	Clout
Makhanana"	Girl's name
Makhanani"	Joy
Makhelwani"	Neighbour
Makolo"	Greed
Makovo"	Prominent brows
Makumu"	End
Makungu"	Plan
Makwavo"	Their sibling
Makwenu"	Your sibling
Makwerhu"	Our sibling. My sibling
Malanga"	Sleep crust 
Malangavi"	Flames
Malebvu"	Beards
Mali"	Money
Malume"	Uncle
Malwandla"	Hospitality
Mama "	Suck
Mamayila"	Xitsonga traditional name
Mamiwa"	Sucked. Be sucked
Mamiwile"	Sucked
Manana"	Mother
Mananga"	Wilderness
Mandhandhi"	Okra
Mangawana"	Black-backed Jackal
Manghovo"	Galago
Mangwa"	Zebra
Mano"	Logic. Reason
Manyoro"	Fertiliser. Humus
Manyunyu"	Pride
Mapa"	Flour
Mapapa"	Clouds
Mara"	But
Marhacici"	-
Marhumbu"	Intestines
Marigugu"	-
Masana"	Sunrays
Masasekani"	One with beauty
Masesi"	-
Maseve"	Friend
Masingita"	Miracles
Masivi"	Pronouns
Matakuxa"	Early morning
Matandza"	Eggs
Mati"	Water
Matiko "	Countries
Matimba"	Strength
Matimu"	History
Matlala"	Initiation school for men
Matlhongweni"	-
Matluka"	Leaves
Matomani"	Mopane worm
Matsalani"	Secretary
Matsavu"	Vegetables
Matshwani"	New
Matsolo"	Knees
Mavala"	Muliticoloured
Mavele"	Breasts
Mavele"	Maize
Maveriveri"	Rumour
Maviti"	Pronouns
Mavizweni"	Synonyms
Mavonakule"	Television
Mavondzo"	Jealous
Mavunwa"	Lies
Maxaka"	Relatives
Maxalani"	Barley
Maxangu"	Hardship
Maxelo"	Weather
Maxinjani"	Squirrel
Mbanga"	Wound
Mbangi"	Dagga
Mbavala"	Bushbuck
Mberha"	Dew
Mbewulani"	Swallow
Mbhaha"	Hen
Mbhambha"	Traditional beer
Mbhongholo"	Donkey
Mbhoni"	Witness
Mbhovo"	Hole
Mbhurhi"	Beautiful girl
Mbila"	Xylophone
Mbilu"	Heart
Mbindzimula"	Demolish
Mbita "	Pot
Mbita-ya-vutivi"	Computer
Mbombomela"	Drown
Mbulwa"	A well-mannered person
Mbuti"	Goat
Mbuyangwani"	Shame 
Mbuyelo"	Returns
Mbvhutamelo "	Ambush
Mbvutamelo"	Ambush
Mbyana"	Dog
Mecisi"	Matches
Meno"	Teeth
Meyila"	Mule
Mfava"	Rubbish
Mfenhe"	Baboon
Mfumo"	Government
Mfumo"	Authority
Mfungura "	Pad lock
Mfungwe"	Civet
Mfutsu"	Water turtle
Mhaka"	Affair
Mhakamuni"	Affair
Mhala"	Buck
Mhalamhala"	Sable
Mhalamhala"	Horn
Mhandzela"	Aardvark. Antbear
Mhangele"	Guinea fowl
Mhangu"	Accident
Mharavunguvungu"	-
Mharigugu"	-
Mheho"	Breeze
Mhelembe"	Rhino
Mhika"	Barren woman. A woman who cannot bear children
Mhiri"	Puff-adder
Mhisi"	Hyena
Mhitlwa"	Waterbuck
Mhofu"	Roan
Mhondzo"	Horn
Mhongolwana"	Dolphin
Mhungubya"	Side-striped Jackal
Mhunti"	Antelope
Micato"	Wedding
Miehleketo"	Memory
Miehleketo"	Thoughts
Miehleketo"	Idea
Migodi"	Mines
Mihlolo"	Miracle
Mihloti"	Tears
Mikateko"	Blessings
Mikateko"	Blessings
Mikhenso"	Thanksgiving
Milawu"	Laws
Mina"	Me
Minete"	Minute
Minkateko"	Blessings
Minwala"	Nails
Minyikelo"	Offerings
Miri"	Body
Miringo"	Temptations
Misava"	Earth
Misaveni"	Earth.
Misisi"	Hair
Misola"	Blame
Mita"	Swallow
Mitsheketo"	Riddles
Mixo"	Morning
Miyelani"	Keep quiet
Mkhumbi"	White Rhinoceros
Mombo"	Forehead
Mona"	Wickedness
Mongo"	Essence of content
Mova"	Sugarcane
Movha"	Car
Moxa"	Damage
Moya"	Air. Wind
Mpahla"	Goods. Clothes
Mpakani"	Beacon
Mpama "	Slap
Mpama"	Beautiful lady
Mpfafarutelo"	Scribbling/ draft
Mpfhapfhapfha"	Nonsense
Mpfilwa"	Vangueria Infausta
Mpfula"	Rain
Mpfumawulo"	Sound. Voice
Mpfundla"	Hare
Mpfundla"	Rabbit
Mpfuno"	Help
Mpfuvu"	Hippopotamus
Mpfuxelelo"	Revival
Mpfuxeto"	Revise
Mphakelo "	Distribution
Mphati"	Royal Herald/Poet
Mphephu"	-
Mpimo"	Size
Mpohlo"	A handsome man
Mpunga"	Rice
Mthavini"	Mthavin
Muahluri"	Judge
Muavanyisi"	Judge
Mubedwa"	Bed
Mubohiwa"	Prisoner
Muchaviseki"	Honourable
Muchayeni"	Komatsuna
Muchayeri"	Driver
Mudlayi"	Killer
Mudyaxihi"	May
Mudyondzisi"	Teacher
Mudzaberi"	Coach
Mufuri"	Smith
Mugimeto"	Saturday
Mugodi"	Mine
Muhadamba"	Kind of tree
Muhandzuri"	Surgeon
Muhanyi"	The living
Muhanyisi"	Healer
Muhaxi"	Broadcaster
Muheberu"	Hebrew
Muhedeni"	Unbeliever
Muhehli"	Heretic
Muhembi"	Liar
Muhizo"	Cloth worn in a careless way.
Muhlaleri"	Spectator.
Muhlamuseri"	Interpreter.
Muhlayisi"	Preserver. Trustee. Warden. Guardian. Keeper
Muhleli"	Publisher. Editor.
Muhloti"	Hunter.
Muhlovo"	Color. Kind
Muhlovo"	Kind. Sort. Species. Colour. Type.
Muhluri"	Conqueror
Muhlwa"	Termite. White ant
Muhocho"	Tunnel.
Muholo"	Salary
Muhosi"	Backyard. Outside rear part of house
Muhundzuki"	Convert.
Muhundzuluxi"	Translator
Mujeko"	Flag. Pavilion.
Muka"	Go home. Go back.
Mukamberi"	Inspector. Scout.
Mukamberinhlori"	Spy.
Mukandziyisi"	Publisher. Printer.
Mukaneti"	Opposer. Adversary
Mukanganyisi"	Humbug. Perjurer.
Mukhacani"	Xitsonga traditional name
Mukhalabya"	Old man.
Mukhamu"	Girdle.
Mukhandziyi"	Rider.
Mukhegulu"	Old woman
Mukhomiwa"	Convict. Captive.
Mukhongeleri"	Intercessor.
Mukhosi"	Alarm. Hue. Cry for help
Mukhotsiwa"	Captive. Convict. Prisoner
Mukhuhlwana"	Flu,  Cold
Mukhuhlwani"	Flu
Mukhumbi"	Pirogue. Canoe.
Mukhuva"	Manner. Habit. Behaviour
Mukhuvuri"	 Baptist
Mukhwakhwa"	Cow disease
Mukisa"	Dismiss. Send home.
Mukoloti"	Debtor.
Mukomberi"	Beggar. Solicitor.
Mukon'wana"	Son in Law
Mukondleteri"	Encourager. Supporter
Mukonwana"	In law
Mukriste"	Christian.
Mukutsuri"	Liberator. Redeemer.
Mukwana"	Knife
Mukwetsimi"	Saint
Muladza"	Whey
Mulamula"	Orange tree
Mulamuleri"	Mediator. Peace maker.
Mulandzeri"	Follower.
Mulandzuri"	Protestant.
Mulanguteri"	Overseer. Guardian. Keeper. Steward
Mulaveleri"	Keeper. Steward.
Muleda"	Velvety stinging bean, the creeper.
Mulerisi-wa-masocha"	Sergeant.
Mulovori"	Bridegroom.
Mulumbeti"	Accuser
Mulunghisi"	Fixer
Muluva"	Acacia
Muluveri"	Foreigner. Stranger.
Muluvisi"	Tribute collecter
Muluvisi"	Tax collector. Toll gatherer.
Mulweri"	Defender. Advocate.
Mulwetani"	Rival.
Mulwi"	Warrior.
Mumbi"	Maker. Creator.
Mumbu"	Swarm.
Mump"	Wasp.
Mumpfu"	Wax.
Mumu"	Sun
Mundle"	Prawn. Shrimp.
Mundlwana"	Day after tomorrow.
Munene"	Someone great
Munghana"	Friend. Companion
Munghezi"	Englishman.
Mungoma"	Diviner. Sorcerer
Mungome"	Premises.
Mungoni"	Zulu
Mungu"	Straw. Husk. Bran
Munhu"	Person
Munhuhata"	Character
Munwi"	Drunkard.
Munyaka"	Soap-stone.
Munyama"	Darkness. Obscurity.
Munyiki"	Benefactor. Donor.
Munyu"	Salt
Muongori"	Nurse
Muoswi"	Alduterer
Mupfali"	Successor.
Mupfulunganyi"	Rebel.
Mupfumari"	Pauper. Poor.
Mupfuni"	Helper.
Muphangi"	Vandal.
Muphati"	Poet.
Muphayini"	Pine.
Muphikisani"	Rival.
Mupindzuri"	Broker. Banket. Merchant. Trader.
Mupireki"	Preacher.
Muponisi"	Saviour
Muprista"	Priest. Monk
Muprofeta"	Prophet.
Mupyopyi"	Drunkard.
Muqaxi"	Employer
Murhandzi"	Lover
Murhandziwa"	Beloved. Darling
Murhangeli"	Leader
Murhangeri"	Predecessor. Precursor.
Murhangeri-wa-tiko"	President
Murhangeri-wa-xikolo"	School principal
Murhi"	Tree. Medicine
Murhi"	Medicine
Murhu"	Sauce
Murhulisi"	Peace maker.
Murhumiwa"	Delegate. Messenger
Murhundzu"	Urine
Murhungi"	Tailor.
Murhurhi"	Relocator. Emigrant.
Murimi"	Farmer. Ploughman cultivator
Muringeli"	Sherman.
Murisi"	Shepherd. Herdsman
Muroho"	Vegetable.
Musa"	Grace
Musi"	A wood used for grinding maize
Musi"	Smoke. Steam.
Musivi"	Substitute.
Musumbunuku"	Monday
Musumi"	Singer. Bard.
Musundzungwani"	Mint.
Musungi"	Strangler
Musunguri"	Initiator. Founder.
Musweki"	Cook.
Mutameri-wa-nkwama"	Treasurer
Mutekiwa"	Bride. Spouse.
Muthofu"	Aluminium
Muthwa"	Tree water-berry.
Muti"	Family
Mutinyiketi"	Volunteer
Mutirhela-mfumo"	Official. Government official
Mutirhi"	Worker
Mutlhokovetseri"	Poet
Mutlhuvutsi"	Tuner.
Mutlhwari"	Olive tree.
Mutluti"	Seaman. Captain of ship. Rower.
Mutsandzeki"	Failure. A person who has failed.
Mutsari"	Writer. Secretary. Scribe. Author
Mutsendzeleki"	Wanderer. Bond. Rover. Vagrant.
Mutshami-wa-xitulu"	Chairman
Mutshu"	Wood.
Mutsutsumi"	Refugee.
Mutswari"	Parent
Mutwa"	Prick. Thorn. Quill
Muvabyi"	Patient.
Muvala"	Colour.
Muvatli"	Sculptor. Carpenter
Muvengi"	Foe. Hater
Muverengi"	Worker
Muvhangazi"	Tree kiaat.
Muvhuru"	Bellows.
Muvilo"	Ferment.
Muvulavuri"	Orator.
Muvuri"	Speaker. Orator.
Muvuva"	Small tree Zulu bush-willow.
Muxaka"	Species. Kind.
Muxanisi"	Persecutor. Oppressor.
Muxanisiwa"	Martyr.
Muxavi"	Buyer.
Muxavisi"	Merchant. Trader
Muxeki"	Surgeon.
Muxengi"	Traitor.
Muxiji"	Black jack. Kind of Vegetable.
Muxisi"	Deceiver
Muyataha"	Shrub
Muyeni"	Guest.
Muyimbeleri"	Singer.
Muyimeri"	Defender. Surrogate
Muyimeri"	Advocate
Muyivi"	Thief. Pickpocket
Muyuda"	Jew.
Muzala"	Nephew. Nierce
Mvavamelo "	Fire heat
N'wa-mapurasi"	Farmer
N'wabava"	-
N'wabuxu"	-
N'wachocho"	-
N'wachochovelani"	-
N'waciciripala"	-
N'wagandla"	-
N'wahuva"	Sorghum
N'wahuva"	Durra
N'walungu"	North
N'wamabidzu"	Business man. Business woman
N'wamatandzeni"	-
N'wambu"	Manilkara Mochisia
N'wamrhofeni"	-
N'wana"	Baby. Child
N'wana-kahina"	Lesser Bushbaby
N'waricici"	-
N'watipepe"	Referee
N'waxemu"	Last year
N'waya"	Scratch
N'wayitelo"	Smile
N'wenga "	Fish
N'weti"	Moon
N'wharhi"	Partridge
N'wheti"	Month
N'wina"	You. (Plural)
N'wingi"	Mother-in-law
N'wini"	Owner. Master
N'winyi"	Owner. Master
Na"	And. With
Nala"	Mourning gown
Nala"	Enemy
Namadyambu"	Evening. In the evening
Nambu"	River
Nambyana"	Stream
Names"	Mavito
Namuneti"	Soft drink
Namuntlha"	Today
Nan'waka"	This year
Nanayila"	Slowly
Nandza"	Subject. Royal servant
Nandzana"	Caracal
Nandzika"	Sweet
Nandzu"	Sin. Crime
Nantswa"	Lick
Naswona"	Even that. Including that
Nava"	Spread
Navela"	Admire. Wish
Navelela"	Wish for
Nawu"	Law
Ncecenyi"	-
Nceka"	Linen
Nchavo"	Fear
Nchumu"	Something
Ncica"	Alter
Ncila"	Tail
Ncimba"	Feces
Ncindzu"	Palm tree
Ncuva "	Traditional game
Ndandazi "	Finger Ring
Nden'wa"	Brat. Spoiled brat
Ndhambi"	Flood
Ndhawu"	Space
Ndhuma"	Fame
Ndhumba "	Shrine
Ndhumbha"	Hut for rituals
Ndhuna"	Local Headman
Ndlala"	Hunger
Ndlandlama"	Broad
Ndlela"	Path
Ndleve"	Ear
Ndlopfu"	Elephant
Ndloti"	Serval
Ndyangu"	Family
Ndzala"	Diamond
Ndzalama"	Emerald
Ndzalama"	Emerald
Ndzawini"	Greeting
Ndzeni"	Inside
Ndzhaka"	Inheritance
Ndzhaku"	Back
Ndzhandzheni"	Overseas
Ndzhati"	September
Ndzheko"	Calabash
Ndzhenga"	Late afternoon
Ndzhombo"	Bee stinger
Ndzhuti"	Shade of a tree. 
Ndzilikani"	Border line
Ndzilo"	Fire
Ndzima"	Part
Ndzimana"	Verse
Ndzimi"	Tongue. Language
Ndzingo"	Temptation
Ndzisana"	Younger sibling
Ndzulamiso"	Correction
Ndzumulo"	Very young child
Ndzumulo"	Weanling
Ndzundza"	Snake
Ndzundzana"	Royal informant
Ndzuvu"	Tribute
Nenge"	Leg
Ngalava"	Ark
Nganakana"	Prince
Nganakati"	Princess
Ngati"	Blood
Ngetelo"	Addition
Nghala"	Lion
Nghamu"	Wife
Nghamula"	Magnate
Nghangha "	Chest
Nghena"	Come in
Nghenelela"	Intervene
Nghenisa"	Put in
Nghilazi"	Glass
Nghinghiya"	Gizzards
Nghohe"	Complexion
Ngholovhani"	Wheelbarrow
Nghondzo"	Hamerkop
Nghozi"	Accident
Nghwavava"	Prostitute
Nghwazi "	Hero
Nghwendza"	Bachelor
Ngoma"	Drum
Ngon'wa"	A man who can't bear children
Ngopfu"	Much
Nguluve"	Pig
Nguluve"	Widower
Ngungumela"	Sneak. (Especially at night)
Ngururu"	Klipspringer
Nguva"	Season. Era.
Ngwenya"	Crocodile
Ngweti"	Iron ore
Ngwidi"	Lead
Nhanga"	Girls' house
Nhenha"	Warrior
Nhlakulo"	Answer
Nhlalala"	Honey bird
Nhlampfi"	Fish
Nhlamulo"	Answer
Nhlana"	Back. Back of human body
Nhlanga"	Reed
Nhlangu"	Common Reedbuck
Nhlantswa"	Milkwood 
Nhlapfura"	-
Nhlata"	Sweet potato
Nhlava"	Amaranthus Cruentus
Nhlayiseko"	Safety
Nhleti"	Grasscutter . Cane rat
Nhlohlotelo"	Influence
Nhloko"	Head
Nhlonghe"	Complexion
Nhlongolwani"	Dam
Nhlungu "	Nipple
Nhluvuko"	Development
Nhompfu"	Nose
Nhonga"	Stick
Nhonga-ya-vuhosi"	Sacred staff
Nhongani"	Fly
Nhongo"	Kudu
Nhova"	Bush
Nhulu"	Heap
Nhundzu"	Goods. Property
Nhutlwa"	Giraffe
Nhwala "	Louse
Nhwana"	Lady
Njhani"	How
Njhingha "	Elegant male
Njhovo"	Cloth made of animal skin
Njiya"	Locust. Grasshopper
Njiyamavele"	-
Njiyamisaveni"	-
Njiyankulu"	-
Njokwa "	Glutton
Njovela "	To fish
Nkahelo"	Steam. Hot air.
Nkaka"	Horned melon
Nkala"	Mongoose
Nkandziyisa"	Publish
Nkandziyiso"	Publication
Nkanjhu"	Cashew
Nkanyi"	Marula
Nkarhi"	Time
Nkata"	Fiance
Nkatamina"	Husband
Nkatanga"	My spouse
Nkateko"	Blessing
Nkava"	Belly button
Nkavani"	Tuna
Nkavavangaheti"	Whale
Nkawu"	Monkey
Nkelukelu"	Nightmare
Nketani"	Chain
Nkhaviso "	Designs
Nkhuhlano "	Friction
Nkhutu"	Platinum
Nkhwakhwa "	Drought
Nkiyasi"	-
Nkolo"	Throat
Nkombe"	Ladle
Nkombo"	Seven
Nkondzo"	Foot
Nkosi"	Funeral. Mourning
Nkova"	Valley
Nkoxi"	Male Royal counsellor
Nkuhlu"	Natal Mahogany
Nkukulu"	Broom
Nkulungwani"	Flute
Nkuma"	Ashes
Nkuma"	Gray
Nkuwa"	Fig
Nkuzi"	Bull
Nkwahle"	Giant Plated Lizard
Nkwakwa"	Muquaqua
Nkwama"	Bag
Nkwikwirimba "	Dull silence
Nombela"	Stamvrug
Nomo"	Mouth
Nona"	Grow fat
Nongonoko"	Program,schedule.
Noni"	Widow
Nonoha"	Be hard
Nonoka"	Go slowly
Norho"	Dream
Noti"	Whistle
Noto"	Zero
Noyi"	Wizard
Nsala"	Green Monkey Orange
Nsati"	Wife
Nsawutiso"	Vaccination
Nsele"	Cruelty
Nsiha"	Nerve. Vein
Nsimba-maxanatsi"	Genets
Nsimbi"	Iron
Nsimu"	Ploughing Field
Nsina"	Copper
Nsinya"	Tree
Nsisi"	Hair
Nsokoti"	Ant
Nsoma "	Anchor
Nsonga"	Waterfall
Nsovo"	Grace
Nsuku"	Gold
Nsuku"	Precious. Gold
Nsuku"	Gold
Nsuna"	Mosquito
Nswanyi "	Cud
Ntalo "	Abundance
Ntamu"	Strength
Ntangha"	Peer
Ntanghu"	Shoe
Nthambo "	Dampness
Nthlari"	Spear
Ntikelo"	Weight. Value.
Ntikiso"	Stress
Ntila"	Line
Ntima"	Black
Ntirho"	Work
Ntirhweni"	At work
Ntlakuso"	Elevation
Ntlangu"	Game
Ntlawa"	Group
Ntlhanu"	Five
Ntlhanu"	50 cents
Ntlhari"	Wiseman. Wisewoman
Ntlhaviketo"	Linking
Ntlhontlho"	Passion. Ambition. Influence
Ntlhwari"	Olive 
Ntlimbo"	Conflict. Constipation
Ntoma"	Jackalberry
Ntondho"	Wild Mango
Ntsakisi"	Source of happiness
Ntsako"	Joy
Ntsena"	Only
Ntsetselelo"	Mercy
Ntshaho"	Quote
Ntshava"	Mountain
Ntshungu"	Crowd
Ntshuxa"	Untie. Free. Emancipate
Ntshuxeko"	Freedom
Ntshwa"	New
Ntshwa-vusiku"	Blister
Ntsindza"	Capital. King's palace
Ntsumbula"	Manihot Esculenta
Ntsumbula"	Cassava
Ntswamba "	Milk
Ntswamba"	Fresh milk
Ntukulu"	Grandchild
Ntumbuluko"	Creation
Ntumi-Ntsumi"	Male Messeger
Ntumikati-Ntsumikati"	Female messenger
Ntwalo"	Fame. Popularity
Ntwanano"	Harmony
Nungu"	Hedgehog
Nurhu"	Stubborn. Attitude
Nwala"	Fingernail
Nxaxamelo"	List
Nxaxameto "	List
Nxikwa"	Earthworm.
Nxorhonxorho"	Cartilage
Nyala"	Onion
Nyama"	Meat
Nyamalala"	Disappear
Nyamalarile"	Disappeared
Nyan'waka"	This year
Nyandlamela"	Sneak. Tread carefully.
Nyanisa"	Affirm. Certify
Nyankwave"	Shark
Nyanyula"	Amuse. Entertain
Nyarhi"	Buffalo
Nyeleti"	Star
Nyenya"	Despise
Nyenyankulu"	March
Nyika"	Give
Nyikela"	Offer. Give to
Nyiketa"	Deliver
Nyikiwa"	Given
Nyikiwile"	Gifted
Nyiko"	Gift
Nyimba"	Womb in pregnancy
Nyimpfu"	Sheep
Nyimpi"	War. Battle
Nyiyi"	Berchemia Discolor
Nyonga"	Thigh
Nyongwa"	Gallstones
Nyonyova"	Stingy
Nyuhela"	Fat
Nyukisa"	Melt. Smelt. Making something glow
Nyuku"	Sweat
Nyuma"	Be shy
Olela"	Pick up
Olova"	Soft
Onge"	As if
Ongola"	Nurse
Onha"	Spoil
Onhaka"	Degenerate
Onheka"	Spoiled
Onhetela"	Destroy
Oswa"	Adultery
Ovhakhadi"	Avocado
Oyili"	Oil
Pala"	Pole. Skull.
Papa"	Cloud
Papalata"	Prevent
Papawa"	Pawpaw
Papila"	Letter.
Paseka"	Easter
Pavalala"	Lie on one's stomach
Pela"	Cross a river
Pempe"	Whistle
Pencisi"	Peach
Penda"	Paint
Peni"	1 cent
Perikisi"	Peach
Peta "	Put Inside
Petsa"	Fold. Bend.
Pfala"	Close. Shut
Pfaleka"	Closed
Pfanganya "	Mix up
Pfhalakaxa"	Suddenly
Pfilunganya "	Confuse
Pfilwa"	Medlar
Pfimba"	Swell
Pfinya"	Rape
Pfuka"	Rise
Pfula"	Open
Pfulela"	Open. Open for
Pfumala"	Lack
Pfumaleka"	Lacking
Pfumela"	Agree. Accept
Pfuna"	Help
Pfunekile"	Helped. assited.
Pfuneni"	Helping
Pfurha"	Burn fiercely
Pfuta"	Leak
Pfuxa"	Wake
Phaphatani"	Butterfly
Phata"	Praise
Phendla"	Page
Phija"	Trip
Phikhokho"	Peacock
Philisi"	Pill
Phoma"	Drip
Phorha "	Maul
Phorisa"	Policeman
Photosa"	Press
Phula"	Take away from fire
Phungubye"	Jackal
Phunta"	Stupid
Phuntisa"	Fool. To fool someone.
Phuphu"	Pillar
Phuphula"	-
Phyembye "	Gorgeous Lady
Phyuphya"	Pure. Rest
Phyuphyisa"	Refreshing
Pima"	Measure
Pimanisa"	Compare
Pipi"	Smoking pipe
Pisalema"	Psalm
Pitori"	Pretoria
Pona"	Escape. Survive
Pondo"	Pound
Pongo"	Noise
Ponisa"	Save
Poso"	Post mail
Poto"	Pot
Pume"	Spider
Purasi"	Farm
Puta "	Feel Pity
Pyeretsetse"	Filthiness
Pyopyiwa"	Drunk. Get drunk
Qamba"	Compose
Qaxa"	Employ
Qhavula"	Shake hands
Qhivi"	Dam
Quva"	Manure
Raha"	Kick
Rahela"	Kick for
Rahile"	Kicked
Ravumbirhi"	Tuesday
Ravumune"	Thursday
Ravunharhu"	Wednesday
Ravuntlhanu"	Friday
Relaxing"	Wisile
Rendzo"	Journey
Rhakarhaka"	Cucumber
Rhaku"	Buttock
Rhama"	Cheek
Rhamba"	Invite
Rhambu"	Bone
Rhandi"	Rand
Rhandza"	Love
Rhandzana"	Love one another
Rhandzekile"	Loved
Rhandzile"	Loved
Rhanga"	Begin
Rhavi"	Branch
Rhayisi"	Rice
Rhebeyila"	Blackberry
Rhenga"	Incline. Late afternoon 
Rhengu"	Plan
Rhengwe"	Anything circular
Rhetela"	Slippery. Smooth
Rheyila"	Drive
Rhidabazi"	-
Rhimila"	Mucus
Rhiya"	Set a trap
Rhole"	Calf
Rhompfa"	African custard-apple
Rhukana"	Insult
Rhuketela"	Insult
Rhula"	Unload
Rhula"	Peace
Rhulani"	Harmony. Peace
Rhuma"	Send
Rhumbu"	Intenstine
Rhurha"	Relocate
Rhurhela"	Receive guest
Rhurhumela"	Shiver
Rhwala"	Carry. Carry Load
Riboboma"	Waterfall
Ribungwa"	Brown
Ribuwa"	Beach
Ribye"	Stone
Ricece"	Small baby
Ridaka"	Mud
Riendli"	Verb
Rifu"	Death
Rifumu"	Wealth
Rifumuni"	Death. What kind of death.
Rifuva"	Asthma
Rihati"	Lightning 
Rihisa"	Fine. Make someone pay
Rihlakahla"	Horned melon
Rihlanganisi"	Conjunction
Rihlanguti"	Side
Rihlaza"	Green
Rikhada"	Infant
Rikhozana"	Falcon
Rikotse"	Last born
Rila"	Cry
Rima"	Plough
Rimpfani"	Chameleon
Rin'wana"	Another
Rindza"	Watch over
Rindzela"	Expect. Wait for something
Ringa"	Tempt
Ringana"	Sufficient
Ringanisa"	Compare
Ringanyeto"	Size
Ringanyiso"	Size
Rinhi"	Stick
Rini"	When
Rinoko"	Attention
Riperile"	Sunset. Night. Good night 
Riperile"	Sunset. Good evening
Ripfalo"	Conscience
Ripfumelo"	Belief
Riqingo"	Telephone
Rirhandzu"	Love
Ririmi"	Tongue
Ririmi"	Tongue
Ririmi"	Language
Risenga"	Xitsonga traditional name
Risima"	Value
Risimati"	A traditional name for men
Risiva"	Feather
Risokoti"	Ant
Risuna"	Scent . Agreeable
Ritiho"	Finger
Rito"	Word
Ritoho"	Monkey
Ritshuri"	Dust
Ritshwa"	Burning bush
Ritukulu"	Hand tremor
Rivala"	Field
Rivala"	Forget
Rivalela"	Forgive
Rivati"	Door
Rivengo"	Hatred
Rivoni"	Lamp
Rivoningo"	Light
Riwa"	Fall. A fall (away from a mountain brink)
Rixaka"	Relative. Kind
Rixile"	Sunrise. Good Morning
Rixiyi"	Eyebrow
Rohetelela"	For the last time
Roko"	Dress
Rona"	That. For nouns starting with 'r'
Sagwadi"	Award
Sahu"	Saw
Sakani"	Black eyed pea
Sala"	Monkey Orange
Sala"	Remain
Salamanga"	Coconut
Sambhoko"	Sjambok
Sangu"	Large mat
Sasavona"	Helper
Saseka"	Pretty
Sasekani"	Beautiful
Sasekile"	Beautiful
Sasekisa"	Beautify. Decorate
Sava"	Sand
Sawutiso"	Contraceptive
Sekwa"	Duck
Siku"	Day
Sila "	Grind
Silivhere"	Silver
Simeka"	Transplant
Simula"	Uproot
Sindzisa"	Force
Singita"	Miracle
Sirha"	Grave
Sirhela"	Conceal
Siva"	Obstruct
Sivara"	Brother in law
Sivela"	Prevent
Siverile"	Prevented
Siya"	Leave
Socha"	Soldier
Sofa"	Couch
Sola"	Blame
Somisa"	-
Sonto"	Sunday
Sovorhi"	Pepper 
Suka"	Depart
Sukumbela"	Centipede
Sula"	Wipe
Sululwani"	Dizziness
Suma"	Intone
Sungukati"	Female Royal counsellor
Sungula"	Begin
Sungulo"	Begining
Sunguti"	January
Susa"	Take off
Susetela"	Remove
Swa"	For. Belonging to
Swahina"	Ours
Swahombe"	Good things
Swakahle"	Good
Swakwe"	Hers. His
Swanga"	Mina
Sweka"	Cook
Swekeni"	Cooking
Sweswi"	Now
Swi"	It. Plural for nouns starting with 'xi'
Swibokisani"	Small boxes
Swicelwa"	Minerals
Swidzidziharisi"	Drug
Swifaki"	Mealies
Swiharhi"	Animals
Swikonso"	Cakes
Swikoxo"	Complaints
Swikunwana"	Toes
Swilo"	Things
Swin'wana"	Others
Swin'we"	Together
Swinene"	Good
Swinene-nene"	Very well
Swirhatana"	Inverted Commas
Swisolo"	Criticism. Doubts
Switsutsusu"	Drizzle
Swivoni"	Mirrors
Swivuriso"	Proverbs
Swoboha"	Mandatory. (It is mandatory)
Swofana"	Same
Swona"	These. For nouns starting with 'swi'
Swukuta"	Chase birds away
Tafula"	Table
Tala"	Rubbish heap
Tala"	Full
Taleni"	Rubbish heap
Tamatinhova"	Wild tomatoes
Tamba"	Fart
Tambha"	Rock
Tana"	Come
Tandza"	Egg
Tapula"	Potato
Tatana"	Father
Tati"	Sister
Teka"	Take
Teka"	Marry
Tekana"	Marry. Marry each other.
Tekele"	Took. Inheriting a personality or looks
Tempele"	Temple
Tende"	Tent
Tengisa"	Purify
Tengiso"	Purification
Thagavele"	-
Thatha"	Roast
Thayele"	Tyre
Thona"	Drop
Thotha"	Dip
Thubobo"	20 cents
Thugamama"	Young girl
Thyaka"	Dirt
Thyakisa"	Pollute
Thyeke"	Amaranthus
Tiboha"	Commit. Bind oneself
Tihanyi"	Cruelty
Tihele"	Hell
Tihlo"	Eye
Tihlolo"	Traditional healer's bones and stones
Tihove-ta-Valungu"	Lantana rugosa
Tika"	Pregant
Tika"	Heavy
Tikhoma"	Restrain
Tikile"	Pregnant
Tikomba"	Show
Tikurisa"	Boast
Tile"	Came
Tilo"	Heaven
Timanga"	Peanut
Timbangi"	Cannabis. Dagga. Marijuana
Timbaweni"	Cowpea
Timbilu"	-
Tin'wana"	Others. Used to refer to e.i. animals in plural.
Tindluwa"	Bambara groundnut. Voandzeia subterranea. 
Tindzhiva"	Dialium Schlechteri
Tingana"	Diffidence. Shyness
Tingani"	How many
Tinguvu"	-
Tingwenya"	Crocodiles
Tino"	Tooth
Tinopisi"	Earings
Tintanghu"	Shoes
Tintiho"	Finger
Tintswalo"	Grace
Tintswalo"	Mercy
Tinxaka"	Kinds. Types
Tinyawa"	Peas
Tinyiko"	Gifts. Presents
Tiphina"	Enjoy
Tirha"	Work
Tirhelo"	System. A way of working
Titimela"	Cold
Titivala"	Faint
Tiva"	Know
Tiva"	Lake. Pool
Tivela"	Know
Tivula"	Give birth to your  first child
Tixiyi"	Eyebrows
Tiya"	Be strong
Tiya-ya-nhova"	Athrixia Phylicoides
Tiyani"	Plural for be strong 
Tiyiselani"	Persevere. Stay strong.
Tlakula"	Carry. Pick up
Tlanga"	Play
Tlangela"	Celebrate
Tlapa"	Flat stone
Tlela"	Sleep
Tlhandluka"	Ascend
Tlharhi"	Spear
Tlhariha"	Be clever
Tlhava"	Stab
Tlhaviwile"	Stabbed
Tlhela"	Go back
Tlhelela"	Go back
Tlherisa"	Return. Take back.
Tluka"	Leaf
Tlula"	Jump
Tobo"	Muskmelon
Tolo"	Yesterday
Tolweni"	Day before yesterday
Toma"	Wild fruit tree
Tona"	That. For nouns starting with 't'
Torha"	Thirst
Tsakamisa"	Make something wet
Tsakani"	Be happy
Tsakisa"	Excite. Make someone happy
Tsala"	Write
Tsalwa"	Manuscript
Tsatsawani"	A Xitsonga name for women 
Tsavu"	Vegetable
Tsengele"	Yellow Plum. Sour plum
Tsetselela"	To show mercy 
Tshaha"	Quote
Tshama"	Seat
Tshamile"	Seated
Tshamiseka"	Settle down. Be Seated
Tshamisekile"	Seated
Tshanga"	Kraal
Tshatshi"	Dandruff
Tshembani"	Believe. (Plural)
Tshembisa"	Promise
Tsheve"	Under the armpit
Tshika"	Leave. Resign
Tshikelela"	Press
Tshindzi"	Tree trunk
Tshinya"	Discipline. Call to order
Tshinyiwa"	Disciplined. Called to order
Tshova"	Break
Tshuka"	Get frightened
Tshuka"	Termite hill
Tshwuka"	Red
Tsikwani"	Hiccups
Tsokombela"	Sweet. Nice
Tsolo"	Knee
Tsona"	Parsimonious
Tsonana"	Parsimonious
Tsongo"	Small
Tsundzuka"	Remember
Tsundzukile"	Remembered
Tsundzuxa"	Remind
Tsundzuxile"	Reminded
Tsundzuxiwa"	Be reminded
Tsutsuma"	Run
Tswala"	Give birth
Tuva"	Dove
Twa"	Hear
Twala"	Audible. Sound
Twana"	Hear. Listen
Twela"	Pity. Feel pity for.
Tyatyasa"	Sharpen
Un'we"	One
Vaaki"	Society
Vabya"	Sick
Vabyisa"	Sicken
Vadzinga-swikamba"	Commoners
Vaendzi"	Visitors
Vakokwana"	Forefathers
Vakon'wana"	Family in law
Valoyi"	Witches
Vamakwerhu"	Siblings
Vamba"	Stretch. Crucify
Vambe"	Foreign. Other
Vambirhi"	Two
Van'wani"	Some
Vana"	Children
Vandla"	Royal regiment
Vandla"	Troop
Vangala"	Amaranthus
Vanhu"	People
Vantukulu"	Offspring
Vatswari"	Parents
Vava"	Painful
Vavisa"	Hurt 
Vaviseka"	Suffer
Velekiwa"	Born
Vendze"	Blood of Animal
Venga"	Hate
Vhiki"	Week
Vhilwa"	Wheel
Vhinyo"	Wine
Vika"	Inform
Vila"	Boil
Vilela"	Grumble
Vindzuka"	Waking early
Vingi"	In-laws
Vinyi"	Royals
Viriviri"	Peri peri
Vita"	Name
Vito"	Name
Voko"	Hand
Vomu"	Deliberately
Vona"	Them
Vona"	See
Vonaka"	Appear
Vonani"	Behold
Vonile"	Saw
Vuhleri"	Indictment. Conviction 
Vuhosi"	Chiefdom
Vukati"	Marriage
Vukona"	Presence
Vukorhokeri"	Service
Vukosi"	Chiefdom
Vukuvuku"	Raven
Vula"	Say
Vulavula"	Talk. Speak
Vulolo"	Laziness
Vulombe"	Honey
Vulongo"	Cow dung. Animal feces
Vumba"	Clay
Vumunhu"	Humanity
Vundzu"	Apple
Vungwa"	Apricot-vine
Vunwa"	Lies
Vunyingi"	Abundance
Vupeladyambu"	West
Vupfumari"	Impoverishment
Vusiwana"	Poverty
Vuswa"	Porridge. Pap
Vusweti"	Poverty
Vutalo"	Detail
Vuthala"	Evidence
Vutho"	Regiment
Vutisa"	Ask
Vutivi"	Knowledge
Vutla"	Snatch
Vutlhari"	Wisdom
Vutluti"	Navigation
Vutomi"	Life
Vutshevi"	Fishing
Vutshila"	Art
Vuxeni"	East
Vuxokoxoko"	Details
Vuya"	Return
Vuyile"	Returned
Vuyisa"	Return
Wa"	For. Belonging to.
Wachi"	Clock
Wansati"	Woman
Wantima"	African
Wanuna"	Man
Wasi"	Blue
Wena"	You
Wisani"	Rest
Wondla"	Take care. Raise a child
Wonge"	Like
Wunga"	Hover
Xa"	For. that.
Xaka"	Relative. Kind. Type
Xakela"	Spoil. Destroy. Seduce a girl.
Xakunwa"	Beverage
Xalamuka"	Wake up. Normal state.
Xalati"	-
Xama"	Tie loosely.
Xambhulela"	Umbrella.
Xambila"	Explore. Work for ﬁrst time. Begin
Xana"	Way of asking a question
Xandla"	Palm. Palm of the hand
Xandlalo"	Bedding
Xandzhaku"	Backwards
Xanga"	Mine
Xangu"	Trial. Sorrow. Grief. Adversity.
Xangula"	Bewitch
Xanisa"	Bother. Persecute. ill-treat 
Xaniseka"	Suffer. Be persecuted. Be grieved.
Xanyatsi"	Mopane tree
Xava"	Buy
Xavela"	Buy something for someone.
Xavelela"	Beg
Xavisa"	Sell
Xavisela"	Sell. Sell for. Sell to
Xawula"	Delicious
Xaxamela"	Go in order. In ﬁle. Fall in line.
Xaxameta"	List. To list.
Xaxameto"	Line up
Xeka"	Carve. Cut with knife
Xela"	Propose
Xenga"	Deceive. Cheat. Betray.
Xengelela"	Lay an ambush. Deceive.
Xengetelo"	Allowance.
Xeva"	Eat some sauce with the ordinary mealie porridge.
Xewani"	Good morning. Good day
Xeweta"	Greet. Hail.
Xewetelo"	Salutation.
Xi"	It
Xiambalo"	Clothing. Vestment.
Xian’wisi"	Mammal.
Xiandziso"	Multiplication.
Xiavelo"	Share.
Xibakabaka"	Inﬁnity
Xibakabakeni"	In space
Xibakele"	Fist
Xibalesa"	Gun. Rifle. Fire arm. Pistol
Xibalo"	Rent. Tax. Tribute. Duty.
Xibamu"	Gun
Xibamubamu"	Spacecraft
Xibariso"	Taxation
Xibawa"	Swamp.
Xibedlhele"	Hospital.
Xibelani"	Knee-length traditional attire worn by women. It is made by a bolt of cloth about 18-metres from a fabric called salempur.
Xibindzulelo"	Shop.
Xibodlo"	Swamp.
Xibodze"	Tortoise
Xibohiwa"	Prisoner. Convict.
Xiboho"	Bond. Pledge. Resolution. Dash(-).
Xibombiso"	Ornament.
Xiborisi"	Bacteria.
Xibowa"	Fowers of certain trees.
Xibudunga"	-
Xibukwana"	Booklet. Publication. Treatise.
Xibundwa"	Mealie bread.
Xibunu"	Afrikaans
Xibuwanyana"	Bit. Small piece of anything
Xibvumbiso"	Imagination. Guesswork.
Xibya"	Utensil. Vessel. Dish.
Xibyari"	Planter.
Xibyevulo"	Razor.
Xichangana"	Shangaan language
Xichavelo"	Refuge. Safeguard. Shelter.
Xichavo"	Respect. Reverence. Honour Deference. Discipline
Xichaya"	Musical Instrument
Xichayo"	Piece of wood used to beat mud ﬂoors
Xichudeni"	Student.
Xiciwana"	Chick. A small chick.
Xicombyana"	Tributary.
Xicongwana"	Tributary.
Xicoticoti"	Spot. Dot.
Xiculu"	Stew
Xidakwa"	Drunkard.
Xidamudamu"	-
Xidarameti"	Glue.
Xidewuli"	Pendulum.
Xidlodlo"	Crown. Title
Xidodo"	-
Xidoledole"	Misunderstanding
Xidonci"	Print
Xidorofiya"	Opuntia
Xidukwana"	Handkerchief.
Xidumo"	Species of shrub.
Xidumo"	Popularity. Reputation. Renown. Fame.
Xidwepfo"	Quill.
Xidyambu"	Sunset. Time about sunset.
Xidyelo"	Pasture. Manger. Stomach. Pot-belly
Xidyi"	Pest.
Xidyohi"	Sinner. Wicked man.
Xidyoho"	Sin. Crime. Fault. Iniquity.
Xidyondzeki"	Intellectual. Educated person
Xidyuhati"	Old person.
Xidzadza"	Tick.
Xidzahelo"	Snuff box.
Xidzana"	Percentage.
Xidzedze"	Hurricane. Whirlwind. Squall. Gale. Gust
Xidzidzi"	Honey badger
Xidzika"	Sediment
Xidzimba"	Songs and dances of hunting rites.
Xidziva"	Pool. Deep water in the river.
Xidzotela"	Very small monkeynut.
Xidzungela"	Berry.
Xidzuniso"	Distinction. Glory.
Xidzuvulo"	Cup.
Xiendleko"	Event.
Xiendliwa"	Object.
Xiendlo"	Action.
Xifafa"	Choleric. Faintness
Xifaki"	Mealie
Xifambi"	Skin boil.
Xifambo"	Transport
Xifanisamatiko"	Geography map.
Xifaniso"	Likeness. Image. Picture. Portrait. Photograph. Appearance. Comparison.Iillustration. Parable.
Xifanyetana"	Lad. Small boy.
Xifasikotana"	Pinafore.
Xifasiterana"	Window. Small window
Xifaxo"	Bodice.
Xifefo"	Comb.
Xifezana"	Whitlow. cob,
Xifihlulo"	Breakfast. First meal
Xifongo"	-
Xifudyana"	Small piece of fat.
Xifufunhunhu"	Insect
Xifufununu"	Coleoptera, beetle, insect.
Xifundha"	District. Region. 
Xifundhakulu"	Province
Xifundza"	Parish, district, region.
Xifundzankulu"	Province.
Xifundzho"	Reverence.
Xifunengelo"	Covering, bedding.
Xifunengeto"	Veil.
Xifunga"	Girdle, sash, belt
Xifuri"	Blacksmith, forge
Xifuta"	Patient.
Xifuva"	Chest
Xifuwana"	Pet.
Xifuwo"	Cattle, one's property, domestic animal.
Xifuyo"	Game farm. Cattle, sheep, goats.
Xiga"	Idiom, sentence, phrase, clause.
Xigadzana"	Bottle. Fiask
Xigalani"	Tick
Xigalanyundzu"	Blacksmith’s anvil.
Xigambu"	Bananas. Bunch of bananas, Bunch of ﬂowers, cluster, a leafy branch cut from the tree.
Xigamelo"	Pillow.
Xigandlu"	Stamp,  printing press.
Xiganga"	Uphill. Ridge. Steep
Xigangu"	Mistress, suitor, lover, concubine‚ sweetheart, harlot.
Xigatlu"	Shrub. Thorny Shrub.
Xigayeri"	Ruminant.
Xigayo"	Mill.
Xigedana"	Small gate
Xigege"	Insinuation. Short person
Xigego"	Metaphor
Xigevenga"	Criminal
Xigidana"	Hoe blade.
Xigingi"	Sound. A sound of feet walking. A sound of dancing instep.
Xigiya"	Knobbed club.
Xigodlo"	Palace.
Xigombo"	Knobkerrie.
Xigono"	Cripple, Inﬁrm
Xigotso"	Possessions, goods, belongings‚ property.
Xigugu"	Food. An African dish made of monkey nuts and mealiepap.
Xigumamapa"	-
Xigwatla"	Quail
Xigwevo"	Sentence. Sanction
Xigwili"	Weathly person. Rich person.
Xigwitsirisi"	Fridge
Xihadyana"	Animal. Small or young wild animal.
Xihaha"	Cactus
Xihahampfhuka"	Aeroplane. Aircraft
Xihahampfuka-phatsa"	Helicopter
Xihahati"	Palm. A palm of hand.
Xihahlu"	Fowl house.
Xihakuntiho"	Thimble
Xihalaki"	Liquid. Fluid
Xihalateki"	Fluid.
Xihambana"	Lamb.
Xihambano"	A cross
Xihambukelo"	Toilet
Xihangu"	Hail
Xiharhi"	Animal. Wild animal. game. beast. brute.
Xihatla"	Impulsiveness, urgency, precipitation.
Xihenge"	Pineapple
Xiheri"	Conclusion, last word
Xihesi"	Weevil.
Xihi"	Which
Xihika"	Boundary.
Xihiso"	Large deep earthenware grater.
Xihitana"	Fable.
Xihitani"	Parable.
Xihlahla"	Wood, forest, thick bush, plantation, shrub.
Xihlahlanyana"	Grove.
Xihlakahla"	Third stomach of cattle.
Xihlakati"	Rag, tatter.
Xihlala"	Island, isle.
Xihlalakatsongo"	Peninsula.
Xihlamariso"	Marvel, surprise, wonder.
Xihlambanyiso"	Proverb, saying, supposition, oath‚ swearing.
Xihlamuselamarito"	Dictionary
Xihlana"	Neck.
Xihlanganiso"	Joint
Xihlangi"	Baby, infant.
Xihlantswameno"	Teeth brush
Xihlapfu"	A branch of a tree which has been cut of
Xihlaya"	Jaw.
Xihlayahlaya"	Story, novel‚ proverb.
Xihlenge"	Island, isle.
Xihlengele"	Cage. A bird's cage.
Xihlohlwa"	Omen.
Xihlohlwana"	Nettle.
Xihloka"	Axe, hatchet.
Xihloni"	Porcupine
Xihlovo"	Fountain, well, spring, cistern, pit, reservoir.
Xihlovomananga"	Oasis.
Xihluke"	Bough, branch, twig.
Xihluku"	Suffocation, choking.
Xihlungulo"	Winnowing basket.
Xihlungwa"	Summit, top of a roof, pinnacle.
Xihluthu"	Long hair hanging down.
Xihluto"	Strainer.
Xihlutwa"	Sample of beer.
Xihodelana"	Inn.
Xihoko"	Alcohol.
Xihondzo"	Tower.
Xihontlovila"	Giant, tall stout man.
Xihorisi"	Ointment.
Xihota"	Patient.
Xihoxo"	Misconduct, blunder, mistake, fault, error, illusion, misstatement
Xihubyana"	Committee.
Xihuhu"	Yolk. A yolk of an egg.
Xihuhuri"	Whirlwind
Xihuhuto"	Bellows.
Xihuku"	Helmet. Hat
Xihumelelo"	Phenomenon.
Xihundla"	Secret, secrecy, intimacy
Xihundleni"	Secretly, in secret.
Xihundzuri"	Rudder, helm.
Xihwata"	Unhealthy.
Xijaha"	Boyhood.
Xika"	Go down, come down, alight, descend, dismount, get off.
Xikafu"	Plane.
Xikaladarata"	Wireless.
Xikalu"	Balance, scale.
Xikambelo"	Exam
Xikambelwana"	Test.
Xikampfu"	Chewed out ﬁbre such as of sugar cane.
Xikandza"	Face
Xikandziyiso"	Press. Printing press.
Xikanekiso"	Fort.
Xikanyakanya"	Bicycle.
Xikarhi"	Between, among, inside, in the middle of, amongst, during.
Xikaringana"	Razor blade.
Xikatsa"	Bundle, bunch, sheaf.
Xikatsakanyo"	Summary.
Xikelema"	Rogue, brute, rascal, scoundrel.
Xikepe"	Boat
Xikero"	Scissors, shears.
Xikete"	Skirt.
Xiketse"	Iron.
Xikhale"	Ancient. Primitive. According to ancient custom.
Xikhameto"	Signal.
Xikhati"	Watch, clock, hom.
Xikhatula"	Shoe
Xikhaviso"	Ornament. Trimming.
Xikhepu"	Taro
Xikhigelo"	Pillow, native wooden headrest.
Xikhino"	Kneehalter.
Xikhiro"	Sanction, suspicious behaviour, conspiracy.
Xikhohlola"	Expectoration, spittle.
Xikhongelo"	Prayer
Xikhongotelo"	Sermon.
Xikhorwiso"	Token, warrant.
Xikhovha"	Owl.
Xikhoweto"	Signal.
Xikhozana"	Falcon, hawk.
Xikhudzwana"	Thumb.
Xikhunguvanyiso"	Scandal.
Xikhutu"	Remaining stub of twig or branch broken or cut off.
Xikhuvi"	Foam. Froth on mouth (oxen), foam, scum.
Xikhuvutiwa"	Pulp.
Xikhuvuto"	Press, mortar.
Xikhwama"	Pocket, bag, sack.
Xikhwarha"	Pangolin
Xikhwehle"	Rain coat
Xikipa"	T-shirt
Xikocikari"	Wagon.
Xikoko"	Crust at the bottom of the cooking pot.
Xikokola"	Elbow.
Xikokomba"	Strong grass growing on the surface of lakes.
Xikokovi"	Reptile.
Xikolo"	School
Xikomaniso"	Supposition, possibility.
Xikombe"	Oar, ear of millet.
Xikombelo"	Request, petition, application.
Xikombiso"	Sign, mark, proof, example‚ model, token, specimen.
Xikombo"	Symbol.
Xikombyana"	Spoon‚ ladle.
Xikomu"	Hoe, plough.
Xikongomelo"	Purpose, aim.
Xikongomiso"	Target.
Xikontiri"	Pitch, tar.
Xikosi"	Occipital. Nape of neck‚ back of the head.
Xikotela"	Dish, basin.
Xikotikoti"	Can.
Xikotlola"	Bowl. Dish.
Xikotlwana"	Owlet.
Xikowa"	Mushroom
Xikoxa"	Elderly. Old woman.
Xikoxa"	Old lady
Xikukwana"	Young chick.
Xikulu"	Big. Main
Xikundzu"	Stump of a tree.
Xikunguva"	Black crow
Xikunwana"	Toe.
Xikurufu"	Stud‚ screw.
Xikutlakutlana"	Small frog.
Xikutsu"	Gourd, receptacle, calabash.
Xikutsuriso"	Ransom.
Xikwa"	Earth worm
Xikwamana"	Purse.
Xikwavava"	Lemon
Xikwekwetsu"	Ship
Xikwela"	Bull
Xikwele"	Quarrel
Xikweleti"	Debt‚ account
Xikwenga"	Cactus, aloe, sisal
Xikwere"	Square.
Xikwerhukwerhu"	Kind of small animal living near water, croaks like frog.
Xilahlo"	Burial.
Xilalelo"	Communion. Evening meal
Xilavi"	Mote
Xilawu"	Mat, couch‚ mattress
Xilebvu"	Chin.
Xilehi"	Sledge.
Xilema"	Inﬁrm, cripple.
Xilembe"	Kind of dance.
Xileriso"	Instruction. Commandment. Decree. Order. Will.
Xiletelo"	Example, model. statute. precept. guilt.
Xileti"	Slate.
Xileyi"	Sleigh, sledge.
Xilo"	Thing, object, substance.
Xilogo"	Claysoil.
Xilondza"	Ulcer, sore, wound.
Xiloso"	Surname, salutation.
Xilotlelo"	Locket, lock, key.
Xiloto"	Whetstone.
Xilukiso"	Texture.
Xilumi"	Ache. (Special to women). Vermin (Noxious insect).
Xilungamunyu"	-
Xilungu"	White people’s customs 
Xilungwa"	Grass bur or prickle.
Xilutsi"	Ebony tree.
Xiluva"	Flower
Xiluvelo"	Place where the chief sits.
Ximamayilani"	Xitsonga traditional name
Ximamayilani"	-
Ximanga"	Cat
Ximangwana"	Foal, raw smallmango.
Ximansa"	Pedlar.
Ximatsatsa"	Beautiful young lady
Ximatsi"	Left side
Ximbahana"	Hen. Small hen.
Ximbhembhe"	Hailstorm.
Ximbhongolwana"	Donkey. Donkey colt. Small donkey.
Ximbhundzhu"	Piece of bread.
Ximbi"	Cock’s spur, bird’s claw.
Ximbilwambilwana"	Impatience
Ximbisi"	Raw.
Ximboni"	Carrot
Ximboni"	Aardvark
Ximbutana"	Goat. Small goat.
Ximbvulwana"	Kind of basket with lid, make like rihlelo.
Ximfumo"	Official
Ximhanimhani"	Motherly
Ximhinsana"	Hyena. Baby hyena.
Ximhungu"	Bateleur eagle.
Ximila"	Plant
Ximilani"	Plant
Ximixweni"	Morning.
Ximofu"	Resin.
Ximoko"	Smoke
Ximonyo"	Discontent. Noise made by the lips to wind. Early in the show disgust or discontent, sarcasm.
Ximpangana"	Small knife.
Ximpfulwana"	Small basket.
Ximudyana"	Bush‚ small thicket‚ shrub.
Ximukeri"	Receptacle.
Ximumu"	Summer
Ximun'wana"	Spring
Ximungwamungwana"	Measles.
Ximunhwana"	Small person, child.
Ximusi"	Holiday, new moon.
Ximutana"	Hamlet.
Ximuwana"	Baobab. Small baobab tree.
Ximuwu"	Baobab
Xin'wanyana"	Other. another thing.
Xin'we"	One, one thing.
Xinakulobye"	Alliance, covenant, pact, treaty.
Xinambyana"	Brook, butary.
Xinamu"	Slowness, tardiness.
Xinana"	Type of frog that likes to inflate itself when threatened. It is always found hiding in damp soil.
Xinandzihisi"	Savoury.
Xinchalana"	Shawl.
Xindla"	Carve meat, cut, dismember.
Xindlelana"	Lane.
Xindlenge"	Dregs, sediment.
Xindodzi"	Weevil.
Xindzekelo"	Cold.
Xindzhabyana"	Small branch.
Xindzhaku"	Rear.
Xindzhakwandzhakwana"	Backwards. Only in backwards. Walk backwards.
Xindzilfwana"	Tonsil.
Xindzin'wana"	Uvula
Xindzingiri"	Waxbill. Blue Waxbill
Xindziwandziwani"	Whirlpool.
Xindzulwandzulwana"	Whirlwind.
Xinefu"	Snuff
Xinembeleti"	Crane.
Xinene"	Right, truth
Xinepe"	Photo
Xingara"	Carry a child in one’s arms.
Xingelengele"	Bell giving high pitched tone.
Xingenge"	Broken pot stil
Xingereretana"	Toy with wheels. spinning top. bicycle.
Xinghana"	Friendship.
Xinghezi"	English.
Xinghole"	Animal's throat.
Xinghwexe"	Bicorn rhinoceros.
Xingomatanda"	Witchdoctor.
Xingomungomu"	Bugbear.
Xingonya"	Malicious violence
Xingorho"	Snoring, grunting.
Xingoya"	Rush used to make mats.
Xingungumela"	One who is walking bent, hiding himself.
Xingwangwa"	Battle axe with long blade.
Xingwavila"	Ring, buckle.
Xingwavila"	Jewelery
Xingwenge"	Stomach.
Xingwexe"	Coin.
Xingwezi"	Name of river
Xinharhu"	Treble.
Xinhlamune"	Quadrangle.
Xinhompfana"	Nose. Small nose
Xinhwana"	Girlhood‚ adolescence.
Xinjengwa"	Kangaroo
Xinjengwe"	Jerboa, springhare.
Xinjovo"	Fishing Rod
Xinkakaka"	Cheetah
Xinkambana"	Pottery dish for eating from, basin.
Xinkampﬁ"	Residue of what is cooked or chewed.
Xinkarhana"	Provisional.
Xinkombyana"	Small spoon.
Xinkontlonkontlo"	Giant, big man.
Xinkunyunkunyu"	One who likes to have elbow room, fat man.
Xinkwa"	Bread
Xinkwakwani"	Strychnos Decussata
Xinodo"	Synod.
Xintanghu"	Shoe
Xintenga"	Goats' disease.
Xintlontlo"	Warrior’s headgear.
Xintshuxo"	Relief
Xintsongwantsongwana"	Virus
Xinuna"	Male, masculine.
Xinungu"	Wrist
Xinwelo"	Cup, tumbler, chalice .
Xinyalani"	Garlic. Onion
Xinyama"	Cursed, bad luck, bad omen.
Xinyami"	Obscure, darkness of moonless night.
Xinyangu"	Get into a job. be insane.
Xinyanyulo"	Tonic. Invigorate
Xinyanyusi"	Stimulant
Xinyata"	Encourage oneself, be courageous, bear pain like a man.
Xinyenyo"	Reluctance.
Xinyimpfana"	Lamb.
Xinyingi"	Many.
Xinyuma"	Shy, timid.
Xionho"	Mischief.
Xipaci"	Purse, bag, Wallet.
Xipaga"	Palm of hand, honeycomb.
Xipalapala"	Skull.
Xipalatsi"	Ebony tree, zebrawood, blackwood.
Xipamu"	Scorpion
Xipandza-mananga"	Car
Xipandzamaribye"	-
Xipandze"	Insect found under bark of dead tree.
Xipandzu"	Venomous spider living in rocks.
Xipandzwa"	Part, portion of food.
Xipani"	Team.
Xipapila"	Fin of a ﬁsh
Xipecele"	Special.
Xipele"	Primer, infant reader book.
Xipelupelu"	Sling, band, windmill.
Xipembele"	Stinkbug.
Xipene"	Antelope
Xipereta"	Pin
Xipesu"	Tail of bird, fanlike tail of certain antelopes.
Xipetlu"	Fragment.
Xipfalo"	Door, covering, shutter.
Xipfimbo"	Swelling, tumour
Xipfundle"	Month of February, season when rivers are in spate.
Xipfuno"	Allowance‚ subsidy.
Xipfunye"	Deep sand.
Xiphamba"	Shell, sole.
Xiphambati"	Small ﬁat object as coin or button.
Xiphandze"	Pass, deﬁle.
Xiphango"	Hail.
Xiphaphana"	Double bellied calabash with small opening.
Xiphatu"	Poem
Xiphemu"	Piece, fragment, fraction, section.
Xiphepherhele"	Fat object, gramophone record.
Xiphiqo"	Problem.
Xiphongo"	He-goat
Xiphorisani"	-
Xiphukuphuku"	Fool, idiot, imbecile, stupid.
Xiphungu"	Granary built on poles.
Xiphunta"	Stupid person
Xiphutsa"	Parcel, bale.
Xiphyuphyisi"	Fan.
Xipikiri"	Nail‚ stud.
Xipilongo"	An imaginary place around Giyani
Xipimamahiselo"	Thermometer.
Xipimbi"	Stub, stump of limb, part, piece.
Xipinga"	Load.
Xipinichi"	Spinach
Xipiri"	Toil, difﬁcult task.
Xipitsipitsi"	Grysbok
Xipixi"	Cat.
Xipoko"	Spoke of wheel.
Xipombolo"	Proﬂigate, libertine.
Xipompana"	Small tap, small pump, small bloodvessel.
Xipopi"	Drunkard.
Xiporo"	Railway track.
Xipotso"	Sports.
Xipuku"	Ghost, phantom.
Xipulu"	Short tail, animal with such tail.
Xipulwana"	Animal with shortened tail.
Xipulwapulwana"	Animal with shortened tail.
Xiputo"	Complaint‚ whining.
Xiputsa"	Purse, pouch, parcel
Xiputselo"	Wrapper.
Xipyopyi"	Alcohol
Xirha"	Enemy, enmity, misfortune.
Xirhabyana"	Small branch‚ twig.
Xirhalanganya"	An obstacle, obstruction,problem.
Xirhami"	Coldness‚ frost.
Xirhandzatiko"	Patriot.
Xirhangana"	First fruits. Premises. Beginning
Xirhangisi"	Underwear
Xirhapa"	Garden, orchard, cemetery. 
Xirhatana"	Apostrophe.
Xirhendza"	Bustle. Busyness
Xirhendze"	Heel. Heel of man. Foot of elephant.
Xirhendzeveti"	Portent as thunder in a clear sky.
Xirhendzevutana"	Round, circle‚ ring
Xirhengele"	Breken pot.
Xirho"	Member, limb, organ.
Xirhodyana"	Young calf.
Xirhomberhombe"	Kind of wild ﬁg tree.
Xirhongo"	Deep sleep.
Xirhumbana"	Pimple.
Xirhumbuko"	Blossom.
Xirhundzu"	Conical basket, bushel.
Xirhurhelo"	Inn.
Xirhuva"	Secret opening, secret door.
Xiri"	Aside.
Xirilo"	Complain, Lamentation, wailing‚ place of sorrow, outcry, petition.
Xirimbana"	Snare, trap
Xirimela"	 Pleiades, six bright stars in the sky ,milky way.
Xirimi"	Rhotacism, disability to pronounce the letter R
Xirimo"	Ploughing season.
Xirindza"	Woman who miscarries.
Xiringo"	Trial, proof, attempt.
Xiririka"	Run down the cheeks (tears).
Xirunguta"	Secret padlock, anthill earth.
Xisa"	Burning coal, brand.
Xisaka"	Bird’s nest.
Xisana"	Brand.
Xisandzu"	Mistake, dirr, profanation, sacrilege.
Xisasi"	Euphemism
Xisati"	Female nature. feminine.
Xiseketelo"	Cushion.
Xisetela"	Cheat, deceive, mislead.
Xisibi"	Soap.
Xisila"	Bad luck,dislike, disdain, scorn, soil.
Xisingarhelo"	Sling.
Xisinya"	Lower part of grassy plant, lower extremity of grass, reed, sugarcane.
Xisirhelelo"	Veil, covering, sereen, protection.
Xisivelo"	Obstruction.
Xisiwana"	Orphan
Xisolo"	Contempt, slander, mockery, disrespect, disobedience, impertinence, offence.
Xisomisani"	Dry seasons
Xisuka"	Bird’s tail.
Xisungulo"	Beginning of an action, or ﬁrst poles forming the structure of a hut.
Xisungunhu"	Elbow, spur.
Xisuti"	Hip. waist.
Xitachi"	Starch.
Xitala"	Stable, stall.
Xitalo"	Frequency, abundance
Xitampu"	Stamp.
Xitanga"	Cooking Hut. Kitchen
Xitanghana"	Grade. Substandard
Xitarata"	Street.
Xitasi"	Station.
Xitatarhi"	Raft.
Xitaya"	Scar.
Xitekwa"	First wife, legitimate wife
Xitempe"	Stamp, postage.
Xitendza"	Large basket, made of grass and ﬁbre.
Xitepisi"	Stair, ladder
Xithathelo"	Hyperbole
Xithombe"	Picture, image, photo 
Xithopo"	Praisename, beacon.
Xithungu"	Aardwolf
Xitichi"	Station. Railway station.
Xitiko"	Fireplace. Family
Xitili"	Steel.
Xitimela"	Train
Xitimu"	Steam.
Xitina"	Brick
Xitina"	Brick
Xitirhi"	Officer
Xitirho"	Instrument, tool‚ utensil.
Xitiringo"	Herdboy’s reedﬂute.
Xititirititi"	-
Xititivato"	Narcotic.
Xitiviso"	Notice, proclamation.
Xitiyisela"	Starch.
Xitladwana"	Small ﬁnger or ear ring.
Xitlakati"	Rag. Tatter.
Xitlakulandzhwalo"	Crane.
Xitlangelo"	Thanks‚ otiering, present.
Xitlangiso"	Toy.
Xitlango"	Toy.
Xitlati"	Barn. Granary built of poles for mealies still on the cob
Xitlen'wani"	Skunk
Xitlhadyana"	Small spear blade.
Xitlhangu"	Shield, buckler.
Xitlhaputlhapu"	Sandals
Xitlhavatlhava"	Stitch.
Xitlhavelo"	Oblation.
Xitlhaveti"	Syringe.
Xitlhavi"	Stitch, pain in the side‚ neuralgia, pneumonia.
Xitlhavo"	Goad.
Xitlhenguso"	Dash.
Xitlhokovetselo"	Idiom
Xitofu"	Stove.
Xitokisi"	Court
Xitokwana"	Lung sickness of cattle.
Xitolo"	Store, shop.
Xitolovelo"	Habit, custom.
Xitolwa"	Ointment.
Xitomi"	Trap made of twigs covered by grass, itself covered by mud.
Xitondolo"	Dissolute.
Xitsalo"	Pen
Xitshembhiso"	Promise
Xitshopana"	Yellow
Xitshungulo"	Rope around waist for spiritual reason
Xitshwuka"	Small hill
Xitsonga"	Tsonga language
Xitsongo"	Small
Xitsongwatsogwana"	Virus
Xitsotso"	-
Xitsundzuxo"	Reminder
Xitsundzuxo"	Reminder
Xitulu"	Chair
Xivala"	Animal Kraal
Xivandzani"	Serpent
Xivatlakombe"	Cobra
Xivelekelo"	Drunkard
Xivelekelo"	Worm
Xivindzi"	Liver. Bravery
Xiviti"	Intellectual
Xivochwa"	Convict, prisoner.
Xivongo"	Surname
Xivoni"	Mirror
Xivulwa"	Sentence
Xivundza"	Boredom
Xivungu"	Worm
Xivuriso"	Proverb
Xivutiso"	Question
Xivuya"	A person who returns home after a failed marriage
Xivuyanyana"	A young person who returns home after a failed marriage
Xixevo"	Relish
Xixika"	Winter
Xixikana"	Autumn
Xiyakayani"	Cucumis Zeyheri
Xiyanimoya"	Radio
Xiyenge"	Part
Xiyi"	Eyebrow
Xiyindlwana"	Cottage, toilet.
Xona"	That.  For nouns starting with 'x'
Xonga"	Gorgeous
Xongile"	Beautiful
Xongotelo"	-
Xuma"	Money paid for Bride 
Xuva"	Miss
Xwela "	Late. Be late
Yehovha"	Jehovha
Yela"	Go on purpose
Yelanisa"	Match. Compare
Yena"	Him. Her. She. He.
Yenavu"	He also. Her also
Yenga"	Betray. Lead to perdition. Deceive.
Yerhu"	Ours
Yeso"	Jesus
Yevula"	Skin an animal.
Yi"	Which. It
Yihi"	Which. Which one
Yikulu"	Big one
Yila"	Taboo
Yima"	Stand
Yimayimeka"	Panicky. Anxious
Yimba"	Circumcision. Tie and cut umbilical cord
Yimba"	Play an instrument.
Yimbelela"	Sing
Yimbho"	Ostrich
Yimbisa"	Bring to the circumcision.
Yimbula"	Uproot. Unearth.
Yimeka"	Perpendicular.
Yimeko"	Position
Yimela"	Represent. Second. Assist. Defend
Yimelo"	Position.
Yimisa"	Halt. Elevate. Erect. Stop. Prevent. intercept
Yindlu"	House
Yingayinga"	Rove. Ramble.
Yingisa"	Listen
Yingisela"	Listen carefully to‚ obey.
Yingwe"	Leopard
Yinhla"	Point. Extremity. Angle. Cornerstone. Basis. Important beginning.
Yinhlanharhu"	Triangle.
Yini"	What
Yinso"	Kidney
Yintshwa"	Flying white ant
Yiva"	Steal
Yoko"	Yoke
Yona"	This one. That one
Yotontswa"	Sharp. Sharp one
Yowee!"	Alas
Yunifomo"	Uniform
Yunivhesiti"	University
Zama"	Try
Zambani"	Potato
Zangazanga"	Girl badly brought up.
Zenya "	Glamorous
Zombe"	Herd of buffalo
Zonda"	Hate
Zukwa"	5 cents
